NO ./textures/sanji.png  
SO ./textures/purple.png
F
WE  ./textures/zoro.png
EA  /Users/gudoyle/Desktop/cube/textures/luffy.png

F   255,255,255
C   255,255,255,123
        1111111111111111111111111
        1000000000110000000000001
        1011000001110000000000001111
       100100000000000S0000000000001
11111111011000001110000000000001111
100000000011000001110101110111111
11110111111111011100000010001
1110111111111011101010010001
1000000110101111000000100011
1000000000000001100000010001
10000000000000001101010010001
11000001110101011111011110001
11110111 1110101 101111010001
11111111 1111111 111111111111