NO ./textures/sanji.png  
SO ./textures/purple.png
WE  ./textures/zoro.png
EA  /Users/gudoyle/Desktop/cube/textures/luffy.png

F   20,255,20

C   54,20,220

111111111111111111111111
100000000000000000000001
100000000001000000000001
100000000000000000100001111
100001000000E00000000000
1000000000000000000000011111
100000000000100000000001
100000000000000000000001
111111111111111111111111