NO ./textures/sanji.png
SO ./textures/luffy.png
WE ./textures/zoro.png
EA ./textures/purple.png

F  223, 255, 0

C  255, 127, 245
011111111111111111111111111111111111111 
1000000001000000000000000000000000000001
1000000001000000000000000000000000000001
100000000100000000000000000000000000000111111111111
1000000001000000000000000000000000000000000000000001111111111111111
100000000100000000000000000000000000000111111111111
100000000W00000000000000000000000000000111111111111
1000000001000000001010010000000000000001110111111111
11111111110000000011100100000000000000011010101
1000000000000000000000000000000000000001010
10000000000000000001000000000000000000011010011010101
1000000000000000000000000000000000000001010110
10000000000000000000000000000000000000011010110
1000000000000000000000000000000000000001010010
 1111111111111111111111111111111111111110101010101101